####################
#                  #
#                  #
#                  #
#                  #
#               X  #
#                  #
#                  #
#        O         #
#                  #
#                  #
#                  #
#                  #
#                  #
#    ~             #
#                  #
#                  #
#                  #
#                  #
####################