####################
#                  #
#      #    #      #
#      #    #      #
#      # "  #      #
#      #    #      #
#  '   #    #  '   #
#      #    #      #
########    ########
# X                #
#            "     #
########    ########
#     O#    #      #
#  '   #    #  '   #
#      #    #      #
#      #    #      #
#      #    #      #
#      #    #      #
#                  #
####################