####################
#  #    ##         #
# #M#  #MM#        #
#  #    ##         #
#                  #
#                  #
#                  #
#       ###        #
#       #X#        #
#       #M#        #
#       ###        #
#                  #
#                  #
#                  #
#                  #
#        O         #
#                  #
#                  #
#                  #
####################