####################
#   #              #
# ' #              #
#   #              #
#####              #
#                  #
#                  #
#                  #
#       X#         #
#                  #
#                  #
#                  #
#                  #
#                  #
#                  #
#        O         #
#                  #
#                  #
#                  #
####################