####################
#                  #
#      #    #      #
#      #    #      #
#      #    #      #
#      #    #      #
#  '   # "  #  "   #
#      #    #      #
########    ########
# X                #
#            '     #
########    ########
#     O#    #      #
#  "   #    #  "   #
#      #    #      #
#      #    #      #
#      #    #      #
#      #    #      #
#                  #
####################