####################
#       "  '       #
# #######  ####### #
#       #  #O      #
#  "   #    #   "  #
#     #  "   #     #
#  ' #        # '  #
#   #    "     #   #
#   #          #   #
#   #          #   #
#                  #
#                  #
#   "    ##    '   #
#        ##        #
#    ##########    #
#        ##        #
#        ##        #
#                  #
#        X         #
####################