####################
#       M  M       #
# #######  ####### #
#       #  #O      #
#  M   #    #   M  #
#     #  M   #     #
#  M #        # M  #
#   #    M     #   #
#   #          #   #
#   #          #   #
#                  #
#                  #
#   M    ##    M   #
#        ##        #
#    ##########    #
#        ##        #
#        ##        #
#                  #
#        X         #
####################