####################
#      X           #
# #######  ####### #
#       #  #       #
#  "   #    #   '  #
#     #  '   #     #
#    #        #    #
#   #          #   #
#   #          #   #
#   #          #   #
#                  #
#                  #
#   "    ##    "   #
#        ##        #
#    ##########    #
#        ##O       #
#        ##        #
#   '          '   #
#                  #
####################