####################
#     #  ######    #
#  M          #    #
#     ######  ###  #
# M   #    #    ####
#   ###    ###     #
#   #        #     #
#####  M           #
#       # # ####   #
#    M  #X######   #
##  #####          #
#       #  #####   #
#       #  #O# #   #
#       ####    #  #
#    ####   ##   # #
#  ##  #       ##  #
#      #    #   #  #
#      #    #####  #
#                  #
####################
