####################
#                  #
#      #    #      #
#  M   #    #  M   #
#      #    #      #
#      #    #      #
#  M   #    #  M   #
#      #    #      #
########    ########
# X                #
#            M     #
########    ########
#     O#    #      #
#  M   #    #  M   #
#      #    #      #
#      #    #      #
#  M   #    #  M   #
#      #    #      #
#                  #
####################