####################
#     #  ######    #
#           X #    #
#     ######  ###  #
#     #    #    ####
#   ###    ###     #
#   #        #     #
#####              #
#       # # ####   #
#       # ######   #
##  #####          #
#       #  #####   #
#       #  #O# #   #
#       ####    #  #
#    ####   ##   # #
#  ##  #       ##  #
#      #    #   #  #
#      #    #####  #
#                  #
####################
