####################
#                  #
#                  #
#    M    M   M    #
#                  #
#                  #
#                  #
#                  #
#                  #
#                  #
#     X            #
#                  #
#                  #
#     O            #
#                  #
#                  #
#                  #
#                  #
#                  #
####################