####################
#      X           #
# #######  ####### #
#       #  #       #
#  "   #    #   '  #
#     #  '   #     #
#  ' #        # "  #
#   #    '     #   #
#   #          #   #
#   #          #   #
#                  #
#                  #
#   "    ##    "   #
#        ##        #
#    ##########    #
#        ##O       #
#        ##        #
#   '          '   #
#        "         #
####################