####################
#      X           #
# #######  ####### #
#       #  #       #
#  M   #    #   M  #
#     #  M   #     #
#  M #        # M  #
#   #    M     #   #
#   #          #   #
#   #          #   #
#                  #
#                  #
#   M    ##    M   #
#        ##        #
#    ##########    #
#        ##O       #
#        ##        #
#   M          M   #
#        M         #
####################