####################
#       "  '       #
# #######  ####### #
#       #  #O      #
#  "   #    #   '  #
#     #  "   #     #
#    #        #    #
#   #          #   #
#   #          #   #
#   #          #   #
#                  #
#                  #
#   "    ##    '   #
#        ##        #
#    ##########    #
#        ##        #
#        ##        #
#                  #
#        X         #
####################